000000000000000000
000111111000000000
000100001000111100
000101101000100000
000100001000101100
000100001000100000
000100001000100000
000100001000100000
000100001000100000
000100001000100000
000100001000100000
000111111000100000
000000000000000000
