000000000000000000
011111111111111100
010000000000000100
010111111111110100
010100000000010100
010101111111010100
010101000001010100
010101011101010100
010100010001010100
010111110111010100
010000000000010100
011111111111110100
000000000000000000
